aa=aa@bitsmart.com
Alan Lloyd=alanglloyd@aol.com
Alex Denissov=
Alex Konshin=alexk@mtgroup.ru
Alexander Radchenko=ravnvt@chat.ru
Alexei Koudinov=
Allan Lyons=
Anders Melander=
André Snepvangers=asnepvangers@users.sourceforge.net
Andreas Hausladen=ahuser@users.sourceforge.net
Andreas Jakobsche=Jakobsche@addcom.de
Angus Johnson=ajohnson@rpi.net.au
Anthony Steele=asteele@iafrica.com
Azret Botash=azret@attglobal.net
Barry Kelly=
Bender Heri=HBender@Ergonomics.ch
Bernhard Berger=bernhardberger@yahoo.de
Bryan Coutch=oracle@bmts.com
Carl Clark=carl@caztec.co.za
Cenon Del Rosario=cenon@mail.com
Charlie Calvert=ccalvert@inprise.com
Chris Morris=
Clayton Collie=
Corrie Engelbrecht=sahfs@iafrica.com
Cybertron_549672=Cybertron_549672@yahoo.com
Daniel Møller=dj@sguft.com
David Butler=david@e.co.za
David Hervieux=dhervieux@Pirel.com
Deian Ivanov=deian@datecs.bg
Dewald Hess=dewaldh@emsoft.co.za
Dick Maley (Advanced Delphi Systems)=rmaley@fenix2.dol-esa.gov
Dylan Thomas=dylan@intelnet.net.gt
Earl F. Glynn=EarlGlynn@att.net
Eric S. Fisher=
Ernesto Benestante=
ESB Consultancy=
Felipe de Toledo Farias=ftfarias@dialdata.com.br
Flier Lu=flier@users.sourceforge.net
Florent Ouchet=ouchet.florent@laposte.net
Hallvard Vassbotn=hallvard.vassbotn@c2i.net
Heinz Zastrau=heinzz@users.sourceforge.net
Helen Borrie=helebor@wr.com.au
Heri Bender=
Huanlin Tsai=
Ivo Bauer=bauer@ozm.cz
Jack Bombeeck=Jack.Bombeeck@Onstream.com
Jack N.A. Bakker=jackb@europdonor.nl
James Azarja=support@jazarsoft.cjb.net
Jean Debord=
Jean-Fabien Connault=
Jean-Philippe BEMPEL=rdm_30@users.sourceforge.net
Jeroen Speldekamp=
Johannes Berg=johannes.berg@gmx.net
John C Molyneux=jaymol@hotmail.com
Jud McCranie=jud.mccranie@mindspring.com
Julien Ferraro=j.ferraro@netcourrier.com
Kevin S. Gallagher=gallaghe@teleport.com
Lasse Vågsæther Karlsen=lasse@cintra.no
Leonard Wennekers=
Liran Shahar=liran_shahar@hotmail.com
Lloyd Kinsella=lloydk@iname.com
Lucjan Lukasik=lucjanl@usa.net
M.H. Avegaart=mavegaart@csstelecom.nl
Malcolm Edgar=edgar@ccis.adisys.com.au
Manlio Laschena=manlio@users.sourceforge.net
Marc Convents=
Marcel Bestebroer=marcelb@zeelandnet.nl
Marcel van Brakel=brakelm@bart.nl
Marcin Wieczorek=wieczor@polbox.com
Marco Klemm=DonLuigi@gmx.net
Mario R. Carro=ochnap2@yahoo.com.ar
Marius le Roux=marius@caddie.co.za
Mark Vaughan=
Martin Kimmings=
Martin Kubecka=
Massimo Maria Ghisalberti=nissl@dada.it
Matt Hamilton=MHamilton@bunge.com.au
Matthias Thoma=mthoma@users.sourceforge.net
Michael Rynn=michrynn@ozemail.com.au
Michael Schnell=mschnell@bschnell.de
Michael Tsai=easyman@ms2.seeder.net
Michael Winter=
Mike Lischke=public@lischke-online.de
Nick Hodges=nhodges@icss.net
Nils Haeck=n.haeck@simdesign.nl
Oliver Schneider=assarbad@users.sourceforge.net
Olivier Sannier=obones@users.sourceforge.net
Patrick van Laake=patrick.vanlaake@ieee.org
Pavel Cisar=pcisar@atlas.cz
Pelle Liljendal=pelle.liljendal@firstconcern.com
Peter Friese=freter@gmx.net
Peter McMahon=fmcmp02@kc.kzn.school.za
Peter Panino=peter-panino@aon.at
Peter Thörnquist=peter3@users.sourceforge.net
Petr Vones=pvones@users.sourceforge.net
Python=
Ralf Junker=ralfjunker@gmx.de
Raymond Alexander=rayspostbox3@users.sourceforge.net
Rik Barker=rikbarker@users.sourceforge.net
Robert Lee=rhlee@nwu.edu
Robert Marquardt=marquardt@users.sourceforge.net
Robert R. Marsh=robmarsh@koit.fanz.net
Robert Rossmair=Robert.Rossmair@users.sourceforge.net
Rudy Velthuis=rvelthuis@gmx.de
Scott Price=scottprice@users.sourceforge.net
SouthEaster=anthony@southeaster.com
Stefan Kirschner=stefan_kirschner@01019freenet.de
Stephane Fillon=sfillon@ifrance.com
Sterling Butts=SterlingButts@Bigfoot.com
Theo Bebekis=bebekis@otenet.gr
Tim Yates=tim@things.demon.co.uk
Tom Hahn=tomhahn@users.sourceforge.net
Uwe Schuster=uschuster@users.sourceforge.net
Wim De Cleen=jones-jr@skynet.be
Yaniv Golan=ygolan@netvision.net.il
